1111111111111111111111111111111111
1P00C000000000000000C000C000100001
1C1001001000101000100100C000110101
1000000010000000100000010001100001
1010010010001110001001000010010101
100C000100010000000000001000000001
1010010000010C0010100100C000010101
101001000001000010101000E000010101
1111111111111111111111111111111111