1111111111111111111111111111111111
1P00C000000011100000000C000C000001
1C1001001000101000100100C000010101
1000000010000000100000010001000001
1010010010001010001001000010010101
100C000000010000000000001000000001
1010010100000C0010100100C000010101
1010010000110000101010000000010101
10100100010010C0001001000010010101
1000000001C010000000C0001000000001
1010010010C00100001001000010010101
1000C00001000010000000C0000C000001
1010010010101000C01001000000010101
10000000000000C000C000011100000001
1010010010101010001001000000010101
100000000000000000000C000000000001
100000000100000C00000000000C0000E1
1111111111111111111111111111111111