1111111111111111111111111111111111
1000C000000000000000000C000C0000P1
1C11111111111111111111111111111111
1000000010000C00100000010001000001
1010010000001010001001C00100010101
11111111111111111111111111111111C1
1010010100000C0010100100C000010101
1010010000100000101010000010010001
10100100010010C0001001000010010101
1000000001C010000000C0001001000001
1C11111111111111111111111111111111
1000C00001000010000000C0000C000001
1010010010101000C01001000000010101
10000000000000C000C000011100000001
1010010010101010001001000000010101
11111111111111111111111111111111C1
100000000100000C00000000000C0000E1
1111111111111111111111111111111111