1111111111111111111111111111111111
1P00C00000001110000N000C000C000001
1C1001001000101000100100C000010101
10000000100N0000100000010001000001
1010010010001010001001000010010101
100C0000000100000N0000001000000001
1010010100000C0010100100CN00010101
1010010000110000101010000000010101
10100100010010C000100100N010010101
1000000001C010000N00C0001000000001
1010010010C00100001001000010010101
1000C00001000010000000C0000C000001
1010010010101000C01001000000010101
1000000000N000C000C000011100000001
1010010010101010001001000000010101
100000000000000000000C000000000001
10000000010000NC00000000000C0000E1
1111111111111111111111111111111111