1111111111111111111111111111111111
1P00C000N00011100000N00C000C000N01
1C1001001000101000100100C000010101
1000N000100000001000N0010001000001
1010010010001010001001000010010101
100C00N000010000N000N000100N000001
1010010100000C0010100100C000010101
101001000011000010101000000N010101
10100100010010C0001001000010010101
100000N001C0100N0000C00010000N0001
1010010010C00100001001000010010101
1000C00001000010000000C0000C000001
1010010010101000C01001000000010101
100000000N0000C000C00N011100N00001
1010010010101010001001000000010101
10000000000N00000N000C0000000N0001
10000N000100000C0000000N000C0000E1
1111111111111111111111111111111111